state_id,party_id,general_votes,postal_votes,total_votes,total_electors
0,9,555,0,555,1968276
0,25,1458,0,1458,2443112
0,27,517239,232,517471,1957931
0,43,9547,6,9553,8661893
0,47,6833,4,6837,1489790
0,80,3619977,6196,3626173,29708615
0,92,14821,10,14831,11689165
0,110,45443,51,45494,8828627
0,123,73829,43,73872,3052418
0,125,82127,64,82191,3099789
0,128,1688,1,1689,4411388
0,163,5491524,5162,5496686,29708615
0,164,586475,84,586559,489573536
0,236,18423,7,18430,5588973
0,263,1058,1,1059,3926207
0,269,190584,214,190798,29708615
0,292,19072,17,19089,18388335
0,333,1415,1,1416,1628033
0,335,2597,1,2598,1479091
0,359,2702,3,2705,1489790
0,377,2624,0,2624,1603318
0,407,1660,0,1660,1513809
0,412,7692130,4718,7696848,29708615
0,445,1223,0,1223,2443112
0,467,3673,1,3674,3130634
0,475,29182,1,29183,1666770
0,522,13544,0,13544,4891327
0,571,1005,3,1008,1585980
0,609,1894,1,1895,1666770
0,623,8316,7,8323,12127569
0,624,2010,2,2012,1506102
0,635,1056,0,1056,1651543
0,647,85716,65,85781,12685938
0,707,2148,7,2155,2443112
0,722,8005,2,8007,1489790
0,734,4179,0,4179,2443112
0,743,719,1,720,3150313
0,830,3501,0,3501,1479091
0,838,3925,2,3927,7179405
0,846,5961,2,5963,10425938
0,856,2776,3,2779,3571594
0,865,3406,1,3407,1513809
0,866,521,0,521,1968276
0,867,56969,104,57073,1424385
0,873,1047,1,1048,1585980
0,897,1319,1,1320,1513809
1,25,1679,8,1687,3167150
1,43,1502,8,1510,3173550
1,47,1752,5,1757,1534256
1,49,1563,0,1563,1650453
1,66,645,4,649,1603220
1,80,297033,6952,303985,37859029
1,110,83061,552,83613,4685623
1,123,26344,192,26536,3234490
1,124,4431,9,4440,3085293
1,125,40747,364,41111,4951973
1,128,4443,1,4444,1521363
1,162,1015,2,1017,1706119
1,163,404368,2609,406977,39405967
1,164,247742,283,248025,158116230
1,173,2385,2,2387,4870323
1,236,583,0,583,1439691
1,269,467918,904,468822,39405967
1,273,1326,15,1341,3025140
1,292,27239,100,27339,31681423
1,311,365,3,368,1570330
1,325,3449,11,3460,1546938
1,331,994,2,996,1534256
1,334,8600,14,8614,7886952
1,335,1804,0,1804,1459556
1,375,7289,4,7293,1573009
1,385,6748,5,6753,3012700
1,406,12434987,80358,12515345,39405967
1,421,4860,4,4864,5185872
1,428,15414453,122553,15537006,39405967
1,468,1261,2,1263,1503980
1,480,2017,6,2023,4738720
1,496,368,2,370,1468671
1,514,5379,132,5511,3173550
1,518,1016,1,1017,1473347
1,612,447,0,447,1706119
1,623,6931,6,6937,6108710
1,627,11445,19,11464,10629453
1,647,1818134,11212,1829346,26661782
1,650,912,1,913,1650453
1,698,7334,8,7342,6252094
1,708,1132,3,1135,1546938
1,710,628,0,628,1706119
1,720,883,4,887,1670391
1,725,1485,4,1489,4929443
1,729,4284,2,4286,1439691
1,742,9711,27,9738,6266209
1,770,1219,1,1220,1664160
1,798,1228,1,1229,1573009
1,823,4981,2,4983,1503980
1,846,2105,2,2107,1573009
1,856,2173,11,2184,3237169
1,888,1723,3,1726,3314613
2,25,1879,42,1921,463775
2,80,365061,14618,379679,803563
2,163,129740,5148,134888,803563
2,164,12833,606,13439,803563
2,178,56814,3064,59878,803563
2,269,7327,137,7464,803563
2,271,26530,589,27119,463775
2,289,26793,910,27703,803563
3,22,1474545,6152,1480697,5278653
3,25,5797,19,5816,3900928
3,31,74288,234,74522,13220847
3,32,1401010,1078,1402088,4883888
3,80,6463366,21230,6484596,14995048
3,92,6930,3,6933,1314319
3,94,1908,164,2072,1858566
3,96,443410,3364,446774,1776358
3,123,31116,111,31227,3073048
3,125,40550,387,40937,3484371
3,152,21835,196,22031,8915233
3,163,6361770,11889,6373659,22050059
3,164,865430,3285,868715,73010048
3,260,10861,149,11010,3207652
3,269,177781,572,178353,22050059
3,271,48292,397,48689,9590745
3,334,11239,11,11250,5725034
3,385,2378,5,2383,2181319
3,470,8196,89,8285,1708013
3,487,21655,23,21678,7037836
3,508,36840,75,36915,795945
3,531,12879,160,13039,7461353
3,724,4214,64,4278,3866468
3,747,21890,525,22415,9296040
3,856,16700,131,16831,9587858
3,861,4102,8,4110,2181319
3,870,3970,3,3973,1685149
3,881,309736,2699,312435,1776358
3,891,50197,158,50355,12509281
4,1,26039,108,26147,5235925
4,8,3579,18,3597,2089353
4,25,16431,23,16454,7021639
4,27,294859,170,295029,1659651
4,31,5481,2,5483,1659651
4,38,10109,18,10127,1792798
4,43,12416,15,12431,1771254
4,47,25229,5,25234,3492474
4,59,18914,89,19003,8720813
4,61,9886,8,9894,1704596
4,75,2226,5,2231,2114809
4,77,23376,38,23414,7994064
4,78,40878,28,40906,11999841
4,80,9572521,47027,9619548,30528989
4,88,1455429,7089,1462518,8394864
4,89,23733,32,23765,13066527
4,92,63318,125,63443,19732250
4,110,678986,3442,682428,61775547
4,120,5672,2,5674,1730553
4,123,278123,2127,280250,3617054
4,124,543997,1099,545096,7248612
4,125,27482,95,27577,1612300
4,152,10963,3,10966,3833623
4,163,3133251,7546,3140797,15935379
4,164,2223781,1693,2225474,413687524
4,179,8875558,27161,8902719,30153609
4,181,27528,56,27584,5134522
4,184,13693,0,13693,1690620
4,188,3545,0,3545,1690620
4,194,30815,38,30853,7012382
4,198,17762,29,17791,8846283
4,199,1789,4,1793,1658672
4,221,3196786,10193,3206979,10533692
4,230,14528,4,14532,1704596
4,248,17936,44,17980,3604343
4,260,38576,415,38991,8982637
4,269,815036,1914,816950,71216290
4,280,5963,2,5965,1752454
4,297,2821,9,2830,1676454
4,317,6247511,23258,6270769,34034601
4,327,16349,22,16371,4983109
4,333,6426,2,6428,2114809
4,334,10273,10,10283,3645215
4,339,3190,5,3195,1730553
4,347,8332,49,8381,1771254
4,349,3768,8,3776,1899747
4,352,10661,60,10721,3575503
4,372,36587,30,36617,9233355
4,377,63862,600,64462,25574545
4,385,2853,28,2881,1771254
4,390,54430,53,54483,11180924
4,400,2062,7,2069,1799551
4,401,6387,8,6395,3813504
4,448,9096,13,9109,1588454
4,455,3424,10,3434,1730553
4,456,32183,35,32218,7092784
4,473,23244,8,23252,3514137
4,490,30960,57,31017,5071670
4,491,4375,3,4378,1658672
4,497,11286,25,11311,3528871
4,506,8353,1,8354,1925479
4,509,11584,14,11598,7460817
4,520,12265,5,12270,3497183
4,528,15221,155,15376,5242028
4,533,1604,9,1613,1667253
4,534,9627,1,9628,1925479
4,535,4962,3,4965,3801024
4,544,1813,1,1814,1686215
4,551,3745,33,3778,2089353
4,552,32413,32,32445,13708233
4,554,4193,15,4208,4073191
4,559,12705,32,12737,5397669
4,564,26054,11,26065,5698960
4,565,2633,7,2640,1807768
4,569,7917,27,7944,1704596
4,576,3604,11,3615,1799551
4,604,11665,13,11678,3412437
4,607,955417,1084,956501,5562288
4,628,34749,21,34770,10789252
4,631,97466,165,97631,1884883
4,638,6163,8,6171,3695793
4,641,9243,21,9264,3341956
4,649,13435,32,13467,7460712
4,651,2362,2,2364,1612300
4,654,17935,20,17955,5680165
4,664,3046,18,3064,1752454
4,670,9863,5,9868,1633824
4,671,2380,4,2384,1735983
4,675,9257,21,9278,3376332
4,679,6313,0,6313,1690620
4,682,6249,18,6267,3922577
4,687,4410,3,4413,1654811
4,719,4442,2,4444,2114809
4,736,13234,4,13238,3819405
4,737,11068,13,11081,3782062
4,739,55398,79,55477,15967556
4,744,20364,70,20434,12699121
4,747,5071,3,5074,1792798
4,751,1975,0,1975,1925479
4,753,67717,65,67782,10743776
4,771,1897,10,1907,1829373
4,778,37523,87,37610,12128954
4,781,1413,1,1414,1925479
4,795,2714,4,2718,1735983
4,800,6483,14,6497,3324174
4,802,55294,509,55803,6630680
4,803,2754,2,2756,1799551
4,812,8616,27,8643,3435964
4,822,2360,4,2364,1799551
4,835,6513,1,6514,2114809
4,837,25586,44,25630,1852417
4,849,3975,3,3978,1735983
4,850,15111,21,15132,3514137
4,856,33056,90,33146,14455321
4,886,17851,5,17856,7182911
4,891,42904,15,42919,10728487
4,893,659240,1466,660706,7345813
4,894,29392,0,29392,1679030
4,896,30473,19,30492,7002315
5,1,25624,23,25647,1136113
5,80,435239,1411,436650,1136113
5,163,365686,472,366158,1136113
5,164,7671,6,7677,2272226
5,269,12466,33,12499,1136113
5,377,1761,2,1763,579352
5,792,2804,5,2809,556761
6,8,1032,2,1034,1655870
6,18,5679,3,5682,3368547
6,43,2796,8,2804,3615879
6,47,1052,3,1055,1643317
6,59,495,2,497,1971658
6,80,18002254,89021,18091275,45152373
6,92,20676,147,20823,10369407
6,94,5258,13,5271,3400656
6,104,613,0,613,1971658
6,106,734,9,743,1945772
6,110,247305,1879,249184,43496669
6,123,5732,3,5735,1655704
6,152,22351,131,22482,16107862
6,163,9283128,53956,9337084,45152373
6,164,625271,1358,626629,344530467
6,229,699,6,705,1811851
6,260,27144,161,27305,5401234
6,269,397725,3207,400932,45152373
6,279,1332,14,1346,1811851
6,292,1468,4,1472,3627362
6,345,3013,3,3016,1971658
6,395,13875,9,13884,5265853
6,429,1294,2,1296,3627362
6,430,3381,10,3391,3539217
6,479,1093,4,1097,1794896
6,518,707,6,713,1662368
6,521,1691,1,1692,1826526
6,557,856,2,858,1794896
6,570,987,5,992,1648869
6,579,178876,1384,180260,10178362
6,603,10423,46,10469,5444873
6,605,1514,10,1524,1662368
6,630,3620,26,3646,7202657
6,653,3220,110,3330,3580148
6,677,625,10,635,1811851
6,684,1879,8,1887,3455168
6,717,2442,7,2449,1811851
6,739,2157,6,2163,3589089
6,772,532,0,532,1655704
6,790,808,3,811,1971658
6,797,3741,21,3762,3387638
6,801,3253,3,3256,1642864
6,808,3557,20,3577,7056810
6,811,1268,22,1290,1801717
6,813,602,2,604,1811851
6,822,3279,3,3282,5191881
6,854,2128,14,2142,3798184
6,856,1613,1,1614,3766554
6,892,14850,124,14974,6889041
6,895,10092,55,10147,10425880
7,1,45378,120,45498,5829720
7,8,1023,4,1027,2150728
7,25,1522,1,1523,3664427
7,55,467,4,471,2071816
7,80,7317269,40078,7357347,18057010
7,92,11156,6,11162,9511421
7,104,4513,19,4532,9536939
7,110,460562,711,461273,14810082
7,123,7540,23,7563,1853711
7,125,9136,14,9150,1631817
7,163,3595408,8698,3604106,18057010
7,164,135366,271,135637,149242635
7,166,239702,556,240258,18057010
7,225,478,0,478,2071816
7,269,41408,373,41781,18057010
7,313,774,0,774,1904193
7,316,532,3,535,1592611
7,333,439,4,443,1654317
7,334,2123,5,2128,1853711
7,336,462,1,463,2071816
7,339,1868,0,1868,2150728
7,353,475,2,477,2071816
7,377,6743,18,6761,5858270
7,426,2474,4,2478,4222544
7,457,6695,34,6729,14621844
7,458,715,1,716,2071816
7,488,545,6,551,1904193
7,518,335,22,357,1592611
7,535,4526,61,4587,8273213
7,543,2039,170,2209,3286134
7,547,765,1,766,1657335
7,550,2687,1,2688,2071816
7,590,337,9,346,2150728
7,594,416,6,422,1737133
7,610,1190,2,1192,2071816
7,640,1235,8,1243,1904193
7,646,617807,2163,619970,12227290
7,680,55128,152,55280,3246928
7,702,595,10,605,1592611
7,721,974,11,985,1657335
7,739,10840,9,10849,11441132
7,744,8049,45,8094,13834466
7,750,1769,8,1777,1631817
7,760,650,8,658,2150728
7,763,527,0,527,2150728
7,766,8993,12,9005,10922221
7,786,507,2,509,1592611
7,789,1848,3,1851,1803349
7,847,5025,2,5027,3496804
7,849,770,0,770,1631817
7,856,5732,28,5760,7134789
7,871,330,0,330,2071816
8,25,7068,29,7097,3902816
8,47,1864,8,1872,1281462
8,80,2620691,40590,2661281,5330154
8,92,462,11,473,1362269
8,104,714,37,751,1281462
8,110,32392,388,32780,5330154
8,125,14742,96,14838,1281462
8,163,1044305,6808,1051113,5330154
8,164,35291,419,35710,24177354
8,269,32552,456,33008,5330154
8,611,950,20,970,1427338
8,713,2355,16,2371,1427338
8,739,508,3,511,1281462
8,752,3789,10,3799,2540547
8,825,2264,55,2319,1362269
8,863,1819,20,1839,2708800
9,25,3833,33,3866,2047302
9,80,1618481,29560,1648041,7922538
9,110,30495,382,30877,3733118
9,152,1261,20,1281,2047302
9,163,1004876,6651,1011527,6627867
9,164,223531,2708,226239,57217487
9,179,1246,4,1250,1294671
9,187,279597,759,280356,4010188
9,188,33398,646,34044,7743306
9,191,83530,524,84054,2715517
9,197,133426,186,133612,4010188
9,269,21232,507,21739,7922538
9,359,500,6,506,1294671
9,377,3307,123,3430,5027789
9,595,25325,1263,26588,3733118
9,622,1708,15,1723,2047302
9,643,1584,28,1612,2047302
9,684,2171,13,2184,2692450
9,725,2701,75,2776,3733118
9,731,36620,80,36700,1294671
9,744,185,32,217,1397779
10,9,4623,1,4624,1775095
10,47,3632,3,3635,1775095
10,52,22603,16,22619,6807919
10,60,5957,14,5971,3410143
10,73,1647,2,1649,1945765
10,77,3342,2,3344,1775095
10,80,17995066,58388,18053454,49382526
10,92,645,0,645,1704010
10,110,410956,1426,412382,51094530
10,123,17222,5,17227,1608545
10,125,21910,13,21923,5059279
10,137,428,1,429,2204817
10,147,385,0,385,2849250
10,150,4397,3,4400,5226573
10,162,3904,2,3906,5093308
10,163,11185553,17463,11203016,39576322
10,164,1365856,1985,1367841,498531284
10,178,3392297,4932,3397229,11518208
10,204,695,1,696,2849250
10,213,2500,10,2510,2215489
10,261,1137,1,1138,1775095
10,269,250454,356,250810,51094530
10,280,1318,2,1320,3932128
10,292,20757,3,20760,11531943
10,297,3538,1,3539,1513806
10,333,1050,9,1059,1612556
10,334,6518,27,6545,5906769
10,345,4856,7,4863,3502364
10,375,46834,5,46839,1724976
10,377,14348,2,14350,3265540
10,380,14210,3,14213,6179916
10,421,540,0,540,2215489
10,475,4989,3,4992,1712004
10,479,1186,3,1189,1727311
10,498,826,3,829,1727311
10,518,2027,1,2028,4624345
10,525,2158,1,2159,3720860
10,535,2372,0,2372,3526829
10,538,1678,7,1685,1556599
10,566,3381,4,3385,6781378
10,597,1438,4,1442,1712004
10,617,3008,9,3017,4420306
10,621,20205,30,20235,5294670
10,623,4623,2,4625,1633064
10,659,2010,3,2013,3512790
10,660,1707,0,1707,1775095
10,661,3082,2,3084,9078336
10,663,1206,1,1207,2849250
10,665,3686,11,3697,3582666
10,691,1609,0,1609,1736693
10,743,742,0,742,1775095
10,744,2049,6,2055,3976122
10,747,1240,1,1241,1775095
10,778,3124,4,3128,1556599
10,793,14733,13,14746,6767137
10,796,5080,1,5081,6342908
10,806,811,0,811,1704010
10,808,1030,3,1033,2849250
10,818,4991,0,4991,1808780
10,830,1009,7,1016,1704010
10,846,3397,0,3397,1751734
10,856,24483,22,24505,13379869
10,879,120602,198,120800,49342796
11,47,3951,7,3958,3985414
11,80,2622677,13133,2635810,19859372
11,110,49835,318,50153,20995837
11,123,1227825,6061,1233886,5376318
11,125,5245300,24941,5270241,23499211
11,163,7576177,20433,7596610,20974071
11,164,816064,1395,817459,151974659
11,173,1110591,1106,1111697,2727347
11,215,420294,752,421046,1206698
11,236,871,0,871,1230197
11,269,103078,518,103596,26204836
11,343,497264,2413,499677,1296720
11,345,379,0,379,1245972
11,375,80076,35,80111,13149092
11,421,1624,4,1628,1204191
11,439,319,1,320,1359679
11,472,844,1,845,1359679
11,527,378992,1855,380847,5138766
11,657,154658,477,155135,1206698
11,704,2829,4,2833,1288926
11,731,3155,1,3156,2586898
11,738,1692,3,1695,1371427
11,830,802,2,804,2626229
11,846,932,0,932,1245972
11,856,11412,115,11527,11737160
12,7,3081,0,3081,1575064
12,25,3234,2,3236,3607429
12,47,32394,29,32423,14594953
12,55,6332,3,6335,3499427
12,80,21355863,51048,21406911,51867474
12,92,34615,27,34642,16132987
12,104,61731,27,61758,19437670
12,110,876364,1649,878013,44732384
12,123,91677,27,91704,7104131
12,125,14248,23,14271,3525081
12,143,111197,315,111512,15768044
12,152,17750,17,17767,15486472
12,163,12713933,19141,12733074,51867474
12,164,698832,316,699148,321755517
12,179,6315,5,6320,1851112
12,245,4453,2,4455,2350580
12,269,340542,442,340984,51867474
12,280,1890,0,1890,1767725
12,285,9905,1,9906,1647399
12,295,4609,3,4612,1741604
12,296,1203,1,1204,2000744
12,325,1430,1,1431,1837723
12,334,9292,7,9299,7078227
12,339,1110,3,1113,2000744
12,342,7354,7,7361,3846291
12,345,2161,3,2164,1575064
12,363,5694,2,5696,1679534
12,377,9872,28,9900,8799703
12,385,82548,114,82662,3489494
12,386,527,1,528,2350580
12,404,2687,1,2688,2142861
12,405,9393,3,9396,1694329
12,425,4285,9,4294,1837723
12,452,571,1,572,2142861
12,453,3467,5,3472,3676468
12,460,46481,114,46595,7006822
12,479,5583,1,5584,1851112
12,484,4024,0,4024,1909055
12,491,6874,5,6879,3521629
12,503,2359,1,2360,1647399
12,504,1423,1,1424,1514783
12,507,930,3,933,1837723
12,512,1321,4,1325,1679534
12,518,7760,0,7760,1760875
12,535,16567,31,16598,13043667
12,541,1055,0,1055,1575064
12,548,1389,3,1392,1819893
12,554,3433,2,3435,1767725
12,560,1311,0,1311,1575064
12,578,4630,2,4632,3480480
12,579,14704,80,14784,1851112
12,586,3351,2,3353,1656474
12,626,7886,2,7888,5711795
12,628,3100,12,3112,5908939
12,645,469,4,473,2142861
12,648,1150,8,1158,1679534
12,664,2582,1,2583,1679534
12,668,2421,5,2426,1679534
12,696,15467,5,15472,5324179
12,707,1747,1,1748,1760875
12,739,35675,28,35703,12434143
12,744,23871,30,23901,15804864
12,745,2304,0,2304,1768777
12,760,929,1,930,1837723
12,762,2271,1,2272,1514783
12,794,824,1,825,1837723
12,805,1964,1,1965,1842095
12,808,483,1,484,2142861
12,813,10552,2,10554,1842095
12,816,6368,0,6368,1845547
12,831,416,2,418,2142861
12,835,15553,5,15558,9093166
12,839,1670,2,1672,1679534
12,845,11872,5,11877,7489085
12,849,28596,22,28618,18361499
12,856,3525,15,3540,5819329
12,862,967,1,968,1837723
12,864,526,1,527,2142861
13,8,849,1,850,2370903
13,10,480,0,480,2161096
13,26,722,0,722,1679891
13,27,388784,258,389042,1886284
13,43,7378,6,7384,7270725
13,47,51611,82,51693,30151576
13,48,4376,23,4399,3576374
13,80,14842490,69649,14912139,46238175
13,91,619,1,620,1908173
13,92,76272,307,76579,65626130
13,104,882,23,905,1811556
13,110,460621,1918,462539,79438202
13,113,491391,205,491596,1885600
13,123,37349,46,37395,3572307
13,125,111183,89,111272,5816796
13,127,1169,0,1169,2161096
13,143,5761,17,5778,3826373
13,150,5580,17,5597,7626432
13,152,2087,9,2096,4302303
13,155,3743,7,3750,1909574
13,163,8761983,30254,8792237,44661880
13,164,1985752,5740,1991492,786891865
13,173,8435,5,8440,5474456
13,193,1347,0,1347,1554176
13,245,672,1,673,2161096
13,257,1652,2,1654,4018253
13,260,8352567,34796,8387363,36710711
13,267,4590,0,4590,1886284
13,269,486485,2281,488766,88676946
13,280,1589,0,1589,1910188
13,282,2712,0,2712,5085947
13,293,10437,9,10446,7458001
13,307,1570,4,1574,1916185
13,309,1819,1,1820,1587079
13,349,1631,1,1632,5000847
13,377,12540410,48654,12589064,42438771
13,385,12292,14,12306,7387090
13,395,997,1,998,2370903
13,398,829292,5088,834380,3585664
13,436,4901,16,4917,6335005
13,452,3183,1,3184,3959596
13,457,1888,2,1890,4761336
13,459,1002,4,1006,1909574
13,462,1562,5,1567,1867220
13,466,734,1,735,2161096
13,467,588,1,589,1440380
13,492,3905,2,3907,1733729
13,495,4852,4,4856,3753504
13,515,3902,17,3919,7748733
13,518,33378,50,33428,24538349
13,520,11358,25,11383,7773307
13,521,52439,135,52574,48805497
13,525,4505,20,4525,6050497
13,530,1428,6,1434,1889740
13,535,5813,9,5822,9564939
13,544,6584,23,6607,1909574
13,550,5560,20,5580,7602638
13,554,1234,0,1234,1647350
13,557,4574,2,4576,10156499
13,567,14741,16,14757,16141824
13,579,22602,71,22673,9287372
13,589,273,0,273,2161096
13,591,2198,1,2199,1440380
13,594,1234,4,1238,2045405
13,608,2727,1,2728,4251353
13,609,7067,15,7082,9663404
13,626,1158,0,1158,1732263
13,628,7046,8,7054,12930689
13,660,9477,16,9493,7394961
13,673,1122,13,1135,1743283
13,676,8373,45,8418,1908173
13,681,2757,4,2761,2045405
13,691,12406,1,12407,3532950
13,699,280500,1078,281578,3341861
13,732,20563,57,20620,1916185
13,739,8600,40,8640,11479960
13,744,1811,1,1812,1886284
13,749,546,1,547,2075824
13,757,1408,17,1425,1775051
13,759,475,0,475,1732263
13,767,8958,39,8997,8607801
13,775,3418,15,3433,3755855
13,778,10819,16,10835,4083860
13,780,697,2,699,1908173
13,784,1931,3,1934,4007224
13,801,664,6,670,1931400
13,808,1489,3,1492,1861396
13,813,1289,1,1290,4018253
13,821,1987,0,1987,1985228
13,824,1957,4,1961,1916185
13,846,2133,1,2134,1455577
13,853,12385,45,12430,5739105
13,856,1083,0,1083,1922764
13,861,445,1,446,2075824
13,885,3729081,14479,3743560,86790662
14,80,548860,4517,553377,1959563
14,123,133093,720,133813,937464
14,163,396075,2312,398387,1959563
14,164,84392,1173,85565,4771955
14,179,2879,108,2987,1022099
14,239,1245,11,1256,937464
14,260,2145,407,2552,1022099
14,269,5238,151,5389,1959563
14,271,30261,465,30726,1022099
14,272,362707,820,363527,1022099
14,695,1755,28,1783,937464
14,714,37019,202,37221,1959563
14,783,739,8,747,937464
15,80,107180,1210,108390,1914796
15,163,659452,662,660114,1914796
15,164,16097,45,16142,3593418
15,269,10849,25,10874,1914796
15,271,304185,270,304455,716990
15,415,267080,176,267256,1197806
16,80,27989,718,28707,792464
16,164,229578,1218,230796,2377392
16,269,2493,16,2509,792464
16,692,223509,777,224286,792464
16,740,13211,112,13323,792464
17,163,481915,2251,484166,1213777
17,164,4316,304,4620,1213777
17,269,2009,55,2064,1213777
17,271,14219,778,14997,1213777
17,712,499683,827,500510,1213777
18,1,1009220,6553,1015773,20892673
18,43,2387,13,2400,3300343
18,47,7496,65,7561,6624662
18,80,1311937,13508,1325445,4700659
18,92,5523,73,5596,9567144
18,104,2299,5,2304,1529431
18,110,479004,784,479788,4913394
18,111,6271,219,6490,6359019
18,123,42245,218,42463,3126294
18,124,10542,74,10616,4746386
18,125,10638,27,10665,1698876
18,163,5506338,16728,5523066,20892673
18,164,234488,618,235106,197827639
18,179,2718,8,2726,1529431
18,210,10654,184,10838,6442010
18,260,5399,290,5689,3225296
18,269,153053,1370,154423,20892673
18,286,678,14,692,1621671
18,291,1593,4,1597,1683325
18,292,2820,4,2824,1698876
18,334,1999,10,2009,3124893
18,343,1730,3,1733,1502861
18,368,3766843,11731,3778574,16192014
18,369,52011,174,52185,3151102
18,377,12757,527,13284,8202211
18,386,1394,12,1406,1621671
18,491,1056,16,1072,1618419
18,511,3663,15,3678,1541971
18,535,4883,68,4951,7874606
18,543,4647,354,5001,3071402
18,555,20151,184,20335,11196554
18,592,463,36,499,1595284
18,593,4820,93,4913,4649578
18,609,1428,2,1430,1617018
18,610,866,36,902,1698876
18,614,1010,4,1014,1683325
18,615,21282,124,21406,13072135
18,618,6094,12,6106,1541971
18,640,3507,59,3566,4885062
18,672,468874,910,469784,4715617
18,706,6504,27,6531,6536685
18,709,161388,257,161645,1739600
18,739,5104,74,5178,6541190
18,748,295198,1422,296620,4802484
18,763,3136,24,3160,3212756
18,766,3285,11,3296,1502861
18,784,6373,42,6415,6509878
18,789,15210,64,15274,1595284
18,794,947,5,952,1618419
18,817,10315,109,10424,1698876
18,819,6041,37,6078,7968247
18,828,2845,72,2917,1597500
18,844,941,43,984,1638842
18,856,5082,24,5106,1621671
18,860,935,7,942,1502861
19,47,88266,106,88372,29377102
19,55,887,4,891,1948010
19,80,18847612,120780,18968392,47022644
19,92,28331,145,28476,8019916
19,110,347376,1302,348678,38910624
19,123,46594,25,46619,6028956
19,125,78179,469,78648,7981903
19,152,1743,2,1745,1851628
19,163,11053562,54348,11107910,48955813
19,164,346868,716,347584,219234319
19,169,9520,18,9538,3858903
19,236,1161,0,1161,1948010
19,269,326502,1057,327559,48955813
19,285,624,2,626,1888524
19,293,2782,1,2783,1810574
19,297,2880,0,2880,4109673
19,325,1487,1,1488,1948010
19,339,12283,1,12284,2071244
19,348,1891,1,1892,1945992
19,377,16537,24,16561,8126909
19,549,12366,50,12416,2041612
19,550,1148,6,1154,1948010
19,568,2862,18,2880,3971646
19,579,313545,1713,315258,8017593
19,594,1859,3,1862,2041612
19,619,2548,21,2569,2161663
19,653,1769,5,1774,1851628
19,723,5796,2,5798,1730289
19,739,2748,3,2751,3857310
19,744,3426,18,3444,1888524
19,778,505,1,506,2127021
19,785,655496,4555,660051,1933169
19,787,788,10,798,1937882
19,797,7397,89,7486,1933169
19,804,347,2,349,2127021
19,808,16715,29,16744,5951121
19,825,8003,3,8006,4085470
19,856,2621,2,2623,2127021
19,861,507,1,508,2127021
20,80,16062,510,16572,434128
20,163,3922,68,3990,434128
20,164,2540,60,2600,868256
20,193,377,6,383,434128
20,269,2257,22,2279,434128
20,373,149158,5331,154489,434128
20,382,161143,5779,166922,434128
20,481,392,4,396,434128
20,613,1943,55,1998,434128
20,843,1479,24,1503,434128
20,858,607,7,614,434128
21,17,8286537,20808,8307345,33549424
21,47,4362,136,4498,1500016
21,80,1544517,7407,1551924,7999696
21,110,160685,887,161572,54000246
21,123,1025389,6228,1031617,2833663
21,124,5278,25,5303,3762411
21,125,1012654,6349,1019003,4999180
21,133,926514,3076,929590,6009838
21,134,14274872,88460,14363332,36649039
21,142,5469,13,5482,4428128
21,163,5373145,32529,5405674,13921238
21,164,3103679,9275,3112954,864154228
21,173,467585,2358,469943,1559740
21,188,1248,3,1251,1547800
21,243,3598,1,3599,2253448
21,269,547298,3279,550577,59941832
21,287,2287527,9904,2297431,10921822
21,291,3314,3,3317,2915464
21,292,1888,2,1890,3305833
21,333,665,5,670,1973533
21,334,5151,7,5158,3279170
21,375,23690,51,23741,1332300
21,416,8964,43,9007,8757905
21,421,498401,1828,500229,1480222
21,467,35211,66,35277,11141772
21,472,4262,12,4274,4360392
21,474,967,5,972,1413599
21,476,1632,133,1765,1484256
21,478,643,2,645,1332300
21,482,2731,33,2764,1484256
21,485,1967,32,1999,1473862
21,486,641,2,643,1332300
21,499,5078,11,5089,2867508
21,505,1356,12,1368,2923485
21,582,491,3,494,1427783
21,587,712,7,719,1438643
21,588,593,3,596,1501250
21,591,12787,22,12809,13513342
21,596,3333,4,3337,2896249
21,600,815,5,820,1501250
21,606,11610,21,11631,4361649
21,617,1811,4,1815,3482496
21,620,747,1,748,1364038
21,688,1113,2,1115,3461214
21,690,265,0,265,1438643
21,693,1570656,4984,1575640,55467344
21,701,2904,2,2906,1303649
21,716,2591,6,2597,2975583
21,728,1663978,8239,1672217,58575772
21,744,7255,24,7279,4426166
21,747,3511,10,3521,2923778
21,796,901,0,901,1438643
21,846,4024,20,4044,1561040
21,856,5755,10,5765,6634766
21,868,220417,432,220849,1461052
21,869,37242,114,37356,24228148
21,874,2509,7,2516,1427783
21,875,688,1,689,1427783
21,882,1237,7,1244,1547800
21,889,1101,7,1108,1528938
22,31,8552,61,8613,1352857
22,40,9669,39,9708,2614718
22,47,7121,12,7133,1352857
22,80,1049655,6003,1055658,2614718
22,125,371672,1117,372789,2614718
22,163,542792,2887,545679,2614718
22,164,34218,70,34288,11720733
22,168,88917,612,89529,2614718
22,269,23102,72,23174,2614718
22,856,4517,8,4525,1352857
22,872,2060,16,2076,1352857
23,1,8617,26,8643,7094349
23,8,2099,5,2104,2040367
23,21,8540,1,8541,1761564
23,25,12060,10,12070,9241140
23,26,1128,0,1128,3343631
23,29,11029,3,11032,1723538
23,39,1764,0,1764,3613628
23,52,12439,18,12457,7108556
23,53,5484,20,5504,5523323
23,54,4086,10,4096,1756837
23,77,907,0,907,1856791
23,80,42705134,153037,42858171,142565915
23,85,9486,17,9503,1790510
23,87,4693,3,4696,7503857
23,92,35295,66,35361,18154592
23,93,915,17,932,1616476
23,101,14136,6,14142,1845150
23,104,20162,41,20203,17271611
23,109,827,2,829,1664125
23,110,16613870,45884,16659754,69330769
23,118,972,12,984,1874824
23,123,119135,88,119223,20344921
23,124,22266,25,22291,5659585
23,125,2391,3,2394,3505079
23,143,3950,52,4002,1822625
23,152,27708,39,27747,24707687
23,163,5441808,15544,5457352,123295201
23,164,853878,543,854421,476977799
23,165,3641,3,3644,3801931
23,174,718,0,718,1739082
23,179,9227,108,9335,5250866
23,199,846,1,847,1743515
23,200,2301,7,2308,3703702
23,201,1555,2,1557,1785605
23,216,1574,0,1574,1743515
23,220,18195,23,18218,9413493
23,230,44664,39,44703,21967319
23,241,2476,1,2477,1848306
23,242,686,1,687,1698003
23,245,1070,0,1070,1679506
23,254,4493,5,4498,3766946
23,257,5630,10,5640,7153976
23,260,4558,12,4570,1942514
23,262,18029,8,18037,7906433
23,269,723081,2016,725097,146134603
23,278,1598,30,1628,1616476
23,282,27259,27,27286,20087076
23,284,11741,11,11752,5428885
23,288,8193,17,8210,5505890
23,296,3367,1,3368,1716160
23,313,974,1,975,2010477
23,325,3508,27,3535,1991651
23,326,1443866,3497,1447363,5122372
23,329,1628,2,1630,1807893
23,333,1999,0,1999,1848306
23,334,1148,2,1150,2728978
23,341,6915,3,6918,3545056
23,342,23568,54,23622,8945703
23,345,18093,30,18123,11527141
23,348,5104,1,5105,6975127
23,349,20338,10,20348,8992083
23,350,3844,1,3845,1667282
23,355,1257,1,1258,1856791
23,358,3265,0,3265,1775196
23,363,1144,0,1144,1743515
23,366,1260,4,1264,2302960
23,372,277178,130,277308,34515944
23,377,29078,58,29136,20496219
23,385,15497538,36082,15533620,68235699
23,386,1982,0,1982,1981197
23,402,2899,2,2901,1789168
23,403,2386,31,2417,1754195
23,423,3751,5,3756,5302097
23,439,503,1,504,1856791
23,440,1431,0,1431,1915408
23,441,1333,3,1336,1891576
23,452,2278,0,2278,1716160
23,453,12999,10,13009,3893713
23,454,838,0,838,1856791
23,457,3747,16,3763,9113146
23,460,1822,9,1831,1761564
23,461,1971,5,1976,1766121
23,463,495,8,503,1616476
23,464,2755,4,2759,1761564
23,469,1038558,920,1039478,3568688
23,471,3418,5,3423,3656527
23,483,1280,2,1282,2302960
23,489,16740,9,16749,12428894
23,493,7561,8,7569,3789306
23,501,2017,0,2017,1867976
23,502,5146,1,5147,1716160
23,507,1057,0,1057,1743515
23,510,4283,0,4283,2023431
23,513,916,5,921,2010477
23,516,8158,6,8164,1754195
23,517,1886,0,1886,1958939
23,518,877,5,882,1892931
23,519,479,10,489,1892931
23,520,1261,1,1262,2010477
23,522,2360,3,2363,1807893
23,524,14052,8,14060,6888618
23,526,1259,9,1268,1787925
23,529,472,0,472,1666703
23,532,1979,16,1995,4001328
23,535,40529,95,40624,29099273
23,539,2146,64,2210,3656942
23,540,6505,3,6508,3603960
23,546,6590,145,6735,7184922
23,550,3877,29,3906,5158060
23,553,2406,16,2422,1698003
23,554,18333,5,18338,1723538
23,555,1260,1,1261,1807893
23,556,1549,0,1549,1816830
23,558,820,2,822,1718837
23,560,2588,9,2597,3605143
23,562,617,2,619,1723236
23,563,1042,5,1047,1616476
23,564,681,0,681,1797655
23,569,314,2,316,1632983
23,572,1694,1,1695,1856791
23,574,1947,1,1948,1743515
23,575,498,3,501,1797655
23,576,3734,21,3755,3489907
23,577,1777,9,1786,1915408
23,580,1845,4,1849,2040739
23,601,560,4,564,1958939
23,616,1432,0,1432,1867976
23,625,1809,3,1812,1723236
23,626,1565,1,1566,1667282
23,628,34928,111,35039,5226438
23,629,4819,54,4873,3489907
23,632,5756,2,5758,3605374
23,634,3724,7,3731,3837437
23,636,1572,0,1572,1981197
23,637,203035,334,203369,3495879
23,639,7180,12,7192,3696103
23,641,24630,8,24638,11483488
23,648,837,3,840,1757984
23,652,2480,4,2484,3362128
23,655,500,12,512,1892931
23,656,6867,19,6886,7132319
23,658,687,0,687,1797655
23,662,6116,4,6120,5566064
23,669,3302,1,3303,2040739
23,674,968,0,968,1770699
23,677,18031,18,18049,11074850
23,678,2723,2,2725,2302960
23,683,1343,1,1344,2114201
23,685,969,4,973,3897158
23,686,1667,2,1669,1708585
23,694,3957,5,3962,1754195
23,700,2413,14,2427,3424687
23,703,1434,19,1453,1787925
23,715,1308,0,1308,1785605
23,718,4842,5,4847,3749053
23,727,2340,2,2342,2114201
23,733,4064,9,4073,1757984
23,737,2366,3,2369,1761564
23,739,13749,18,13767,14582491
23,741,5450,1,5451,5357123
23,744,264903,677,265580,85950111
23,756,2058,0,2058,2010477
23,758,770,6,776,1766121
23,761,4013,3,4016,3826420
23,764,3942,2,3944,2728978
23,765,5768,0,5768,1867976
23,768,2283,8,2291,5031938
23,769,582,2,584,1621295
23,777,7560,1,7561,3535854
23,778,3539,1,3540,1770248
23,779,1599,1,1600,1991651
23,786,2554,3,2557,3452308
23,788,1771,0,1771,1856791
23,791,1222,3,1225,1887127
23,799,1547,1,1548,1796932
23,807,1059,1,1060,1770699
23,808,707,2,709,2728978
23,810,1323,3,1326,1937690
23,813,7099,7,7106,5642057
23,814,2747,4,2751,3399104
23,815,1351,9,1360,4345454
23,820,2214,0,2214,1805946
23,822,2249,1,2250,2114201
23,825,9165,41,9206,1845150
23,826,2856,1,2857,1915408
23,829,3910,9,3919,6653233
23,832,3132,7,3139,3840261
23,833,6280,3,6283,5348888
23,834,870,12,882,3673350
23,835,2741,3,2744,1756837
23,836,1305,1,1306,1981197
23,840,2038,3,2041,1848306
23,856,6119,2,6121,3576735
23,859,2548,6,2554,3283179
23,862,24504,22,24526,14562560
23,876,451,0,451,1679506
23,887,3690,4,3694,3696103
23,890,1529,0,1529,1770248
23,891,7279,6,7285,8837101
23,898,2858,0,2858,2010477
24,25,238758,554,239312,5178336
24,31,24731554,25791,24757345,70001284
24,37,8481,3,8484,1641868
24,40,18546,16,18562,8588036
24,47,3267,2,3269,1601220
24,80,22960119,68398,23028517,70001284
24,92,36601,19,36620,9790542
24,94,9400,0,9400,1699219
24,110,221197,457,221654,61662589
24,123,227453,242,227695,5152595
24,124,15591,6,15597,3398299
24,125,3604040,6605,3610645,59720200
24,163,3204821,5670,3210491,66535521
24,164,541518,283,541801,183778054
24,172,4000,3,4003,3400460
24,183,4158,6,4164,1648906
24,190,11165,39,11204,1641868
24,194,12925,11,12936,6364763
24,211,5876,9,5885,3363565
24,269,546029,759,546788,70001284
24,281,12083,4,12087,8107357
24,292,965,0,965,1444082
24,303,440,0,440,1444082
24,320,8586,23,8609,8360977
24,334,1798,5,1803,1638378
24,343,207998,277,208275,6366820
24,352,32181,3,32184,3404292
24,360,23570,10,23580,10098540
24,375,11693,3,11696,1616213
24,377,52802,48,52850,26306219
24,397,1894,5,1899,1735464
24,427,23021,14,23035,3430413
24,437,2927,25,2952,1611317
24,475,6102,8,6110,4893243
24,477,6364,131,6495,1611317
24,494,2707,0,2707,1678357
24,535,1757,2,1759,3138728
24,542,6511,0,6511,3089966
24,561,31299,9,31308,11972009
24,618,1670,8,1678,1611317
24,633,712,0,712,1444082
24,642,2212,8,2220,1648906
24,653,1301,0,1301,1444082
24,666,12621,45,12666,9879860
24,697,4051,6,4057,3462741
24,711,7080,1,7081,4866647
24,747,5914,3,5917,4694220
24,755,1225,1,1226,1694646
24,855,730,0,730,1633925
24,856,217178,198,217376,70001284
24,884,2375,0,2375,1678357
25,7,3844,1,3845,1425218
25,25,15667,16,15683,7008660
25,31,71792,278,72070,9676013
25,34,646864,1413,648277,1649413
25,40,8295,5,8300,3775913
25,43,4100,21,4121,1881441
25,47,25740,79,25819,6961789
25,77,1840,2,1842,1667465
25,80,7603480,20507,7623987,20755443
25,91,1850,14,1864,1202664
25,92,17945,62,18007,8774690
25,110,165952,567,166519,22404856
25,123,70782,61,70843,4489936
25,124,73180,31,73211,3695566
25,125,41268,15,41283,6955115
25,152,4986,1,4987,3268561
25,163,2333098,5368,2338466,10788143
25,164,620663,584,621247,152787859
25,189,34821,239,35060,6056188
25,190,7665,0,7665,1703279
25,194,1718367,4268,1722635,6204381
25,195,8640,32,8672,1269917
25,198,4988,10,4998,3548906
25,206,747909,2890,750799,3530891
25,217,5645,2,5647,1269917
25,248,3254,0,3254,1814125
25,269,189006,359,189365,22404856
25,297,4277,9,4286,3797400
25,317,359958,1520,361478,3306659
25,334,7715,14,7729,3565372
25,385,1446,7,1453,2072634
25,425,4487,3,4490,3463538
25,456,2625,2,2627,1716766
25,475,9779,7,9786,4555356
25,523,2698,3,2701,1425218
25,535,3476,3,3479,3370744
25,537,1527,0,1527,1667465
25,554,1074,14,1088,1649413
25,555,13039,8,13047,1881441
25,557,1203,3,1206,1649413
25,581,1463,0,1463,1703279
25,609,2362,11,2373,1202664
25,626,3973,10,3983,3481590
25,642,13955,20,13975,4525750
25,644,1236,8,1244,1649413
25,653,4163,1,4164,1881441
25,739,6869,16,6885,7359337
25,745,6571,9,6580,1716766
25,747,4483,0,4483,1425218
25,776,4891,6,4897,3730084
25,802,2302,5,2307,1716766
25,808,2481,0,2481,1703279
25,809,3888,7,3895,1202664
25,856,12693,22,12715,8629254
25,880,2045,6,2051,1649413
25,891,5094,5,5099,1881441
26,80,2900411,54422,2954833,7856318
26,92,2846,10,2856,3669171
26,110,215997,758,216755,6500522
26,124,5468,20,5488,1828433
26,125,6605,21,6626,1493543
26,152,884,13,897,1840738
26,163,1511982,8785,1520767,7856318
26,164,47690,313,48003,26910108
26,269,50394,552,50946,7856318
26,418,5291,60,5351,1337808
26,523,935,2,937,1840738
26,735,3332,7,3339,1828433
26,739,734,4,738,1840738
26,744,705,2,707,1840738
26,827,673,15,688,1493543
26,856,1404,33,1437,1355796
26,877,12440,189,12629,6027885
26,878,8667,163,8830,6027885
26,883,1090,8,1098,1493543
27,1,2837,2,2839,318471
27,31,1717,4,1721,318471
27,80,93772,129,93901,318471
27,110,2478,8,2486,318471
27,163,95249,59,95308,318471
27,164,9404,13,9417,2866239
27,269,1411,1,1412,318471
27,479,212,0,212,318471
28,1,13767,14,13781,646729
28,25,164,0,164,646729
28,43,245,0,245,646729
28,80,230967,221,231188,646729
28,92,919,1,920,646729
28,110,7391,5,7396,646729
28,111,312,0,312,646729
28,125,377,0,377,646729
28,163,184117,101,184218,646729
28,164,4713,1,4714,8407477
28,210,486,0,486,646729
28,269,4321,14,4335,646729
28,334,212,0,212,646729
28,359,194,0,194,646729
28,491,209,0,209,646729
28,535,531,0,531,646729
28,536,461,0,461,646729
28,547,452,0,452,646729
28,550,285,0,285,646729
28,557,1578,0,1578,646729
28,584,3182,4,3186,646729
28,615,365,0,365,646729
28,766,158,0,158,646729
28,819,658,0,658,646729
28,860,143,0,143,646729
29,80,81384,36,81420,250029
29,92,1596,0,1596,250029
29,110,948,0,948,250029
29,163,8608,0,8608,250029
29,164,97436,22,97458,1000116
29,269,2950,0,2950,250029
29,377,4000,0,4000,250029
29,579,843,0,843,250029
29,726,1160,0,1160,250029
30,80,37586,11,37597,121740
30,110,790,2,792,121740
30,163,27643,12,27655,121740
30,164,19935,3,19938,121740
30,269,1487,0,1487,121740
31,1,1570328,1359,1571687,14327649
31,8,403,0,403,2067463
31,10,404,1,405,1617470
31,25,366,1,367,2067463
31,43,2147,1,2148,2290492
31,54,641,0,641,1617470
31,80,4897051,11490,4908541,14327649
31,97,724,0,724,2378995
31,110,93599,378,93977,10331184
31,163,1952071,1829,1953900,14327649
31,164,30753,11,30764,86834163
31,188,919,1,920,1617470
31,193,1531,6,1537,2067463
31,198,1393,0,1393,4329794
31,269,45523,131,45654,14327649
31,277,1052,1,1053,4439107
31,280,4223,0,4223,6001390
31,292,2830,0,2830,9658162
31,294,1400,0,1400,9658162
31,296,1897,0,1897,2067463
31,334,2781,2,2783,9881191
31,339,2244,0,2244,5247216
31,434,434,1,435,2290492
31,452,1289,2,1291,5247216
31,457,6477,7,6484,11948654
31,500,1280,1,1281,1617470
31,507,636,0,636,3989114
31,533,1651,0,1651,4106765
31,535,2169,1,2170,3852775
31,550,288,1,289,2039302
31,553,848,1,849,5470245
31,583,958,0,958,4329794
31,585,275,0,275,1617470
31,598,1270,0,1270,1562283
31,609,3892,0,3892,2067463
31,648,1708,0,1708,2067463
31,656,369,0,369,1562283
31,689,5017,0,5017,10338535
31,705,1044,0,1044,2039302
31,739,4193,8,4201,9658162
31,755,370,0,370,2067463
31,760,1579,0,1579,5973229
31,774,1648,0,1648,5558748
31,778,249,0,249,1562283
31,784,551,0,551,2371644
31,808,2296,1,2297,3852775
31,822,309,0,309,2290492
31,825,3028,1,3029,6789941
31,841,419,0,419,2290492
31,848,805,0,805,2378995
31,851,740,0,740,2290492
31,856,1749,0,1749,2290492
31,870,699,0,699,2039302
31,883,943,0,943,2039302
31,891,314,0,314,2067463
32,80,103,22,125,55189
32,123,141,2,143,55189
32,125,419,1,420,55189
32,163,21980,48,22028,55189
32,179,1339,3,1342,55189
32,260,22796,55,22851,55189
32,269,99,1,100,55189
33,28,247844,112,247956,973410
33,110,2685,4,2689,973410
33,124,904,1,905,973410
33,163,444646,335,444981,973410
33,164,15618,8,15626,7787280
33,269,12192,7,12199,973410
33,467,673,1,674,973410
33,472,2199,2,2201,973410
33,693,38046,22,38068,973410
33,728,22842,15,22857,973410
33,746,1318,1,1319,973410
33,856,1285,0,1285,973410
34,47,57639,64,57703,19016462
34,71,1069,0,1069,2111738
34,80,6883720,18757,6902477,19016462
34,92,8759,10,8769,5286178
34,104,14898,33,14931,9146044
34,110,311905,1356,313261,19016462
34,123,38388,7,38395,1379122
34,125,2259,4,2263,1637951
34,127,1519,3,1522,1940269
34,143,85891,206,86097,15999389
34,163,5558009,11174,5569183,19016462
34,164,259789,113,259902,99282429
34,269,196088,177,196265,19016462
34,330,1504,2,1506,1716459
34,334,2560,1,2561,3828197
34,377,50677,42,50719,15869671
34,390,9056,4,9060,1655239
34,465,9910,2,9912,1379122
34,512,2198,3,2201,1876953
34,535,775,0,775,1940269
34,538,5043,2,5045,3385793
34,550,7086,7,7093,5928960
34,554,823,3,826,1876953
34,573,1851,1,1852,1876953
34,579,5478,23,5501,3242645
34,581,1984,2,1986,1508840
34,586,2184,3,2187,1897134
34,599,1518,1,1519,1716459
34,623,797,0,797,1940269
34,662,1843,11,1854,1733805
34,739,6237,3,6240,1897134
34,744,8847,40,8887,1733805
34,773,1847,3,1850,1897134
34,782,16883,19,16902,12628124
34,813,1208,2,1210,2111738
34,831,12107,0,12107,1940269
34,852,2801,1,2802,2111738
34,856,3687,3,3690,4052007
34,857,2565,3,2568,1897134
34,863,964,2,966,1876953
35,1,6605,9,6614,1531525
35,7,16544,5,16549,4722614
35,25,11848,5,11853,3057833
35,31,9545,31,9576,4893120
35,43,6542,11,6553,3000311
35,47,58201,50,58251,9406414
35,80,9081694,49074,9130768,32497762
35,92,38155,62,38217,7840402
35,110,180281,1215,181496,26248533
35,123,59889,89,59978,1541145
35,124,28760,8,28768,2996715
35,125,56877,52,56929,9225882
35,143,2694,5,2699,1468530
35,152,10967,6,10973,3035928
35,163,3276677,8662,3285339,27763734
35,164,160178,158,160336,49087848
35,194,135265,287,135552,1493205
35,198,3219,3,3222,3118602
35,217,6777,8,6785,6442666
35,269,310530,294,310824,32497762
35,280,4467,3,4470,1475007
35,385,5143,5,5148,1710916
35,535,3457,10,3467,2987526
35,545,10159902,14119,10174021,32497762
35,557,2913,1,2914,1504403
35,602,6876,8,6884,4818280
35,667,8505,5,8510,4929590
35,730,8293,11,8304,1502455
35,744,4610,6,4616,3000311
35,747,1241,0,1241,1531781
35,754,10911,3,10914,1516688
35,842,3874,3,3877,1504403
35,856,38414,60,38474,12407023
